++++++++++++++++++++++
+ O +   ++ ++        +
+     +     +++++++ ++
+ +    ++  ++++ +++ ++
+ +   + + ++         +
+          ++  ++  + +
+++++ + +      ++  + +
+++++ +++  + +  ++   +
+          + +  + +  +
+++++ +  + + +     X +
++++++++++++++++++++++
